"a" = (/turf,/area)
"b" = (/turf/shadow/shadow11,/area)
"c" = (/turf/shadow/shadow17,/area)
"d" = (/turf/shadow/shadow1,/area)
"e" = (/turf/inside/walls/walls13,/area/insidedensity)
"f" = (/turf/shadow/shadow3,/area)
"g" = (/obj/decoration/decoration4,/turf/inside/walls/walls13,/area/insidedensity)
"h" = (/turf/inside/walls/walls14,/area/insidedensity)
"i" = (/obj/decoration/decoration4,/turf/inside/walls/walls14,/area/insidedensity)
"j" = (/obj/classroom/board4,/turf/inside/walls/walls14,/area/insidedensity)
"k" = (/obj/classroom/board5,/turf/inside/walls/walls14,/area/insidedensity)
"l" = (/obj/classroom/board6,/turf/inside/walls/walls14,/area/insidedensity)
"m" = (/turf/inside/walls/walls17,/area/insidedensity)
"n" = (/turf/konoha_houses/Door3,/turf/teleport/buildingteleports/Konoha_Kage_House_Top/_1/Top,/area)
"o" = (/turf/konoha_houses/Door3,/turf/teleport/buildingteleports/Konoha_Kage_House_Top/_2/Top,/area)
"p" = (/turf/konoha_houses/Door3,/turf/teleport/buildingteleports/Konoha_Kage_House_Top2/_1/Top,/area)
"q" = (/turf/konoha_houses/Door3,/turf/teleport/buildingteleports/Konoha_Kage_House_Top2/_2/Top,/area)
"r" = (/turf/inside/floors/floors11,/area)
"s" = (/turf/inside/floors/floors08,/area)
"t" = (/obj/classroom/chair,/turf/inside/floors/floors08,/area)
"u" = (/obj/classroom/table1,/turf/inside/floors/floors08,/area/insidedensity)
"v" = (/obj/classroom/table2,/turf/inside/floors/floors08,/area/insidedensity)
"w" = (/obj/classroom/table3,/turf/inside/floors/floors08,/area/insidedensity)
"x" = (/turf/shadow/shadow5,/area)
"y" = (/turf/konoha_houses/Door3,/turf/teleport/buildingteleports/Konoha_Kage_House_Top/_1/Down,/area)
"z" = (/turf/konoha_houses/Door3,/turf/teleport/buildingteleports/Konoha_Kage_House_Top/_2/Down,/area)
"A" = (/turf/konoha_houses/Door3,/turf/teleport/buildingteleports/Konoha_Kage_House_Top2/_1/Down,/area)
"B" = (/turf/konoha_houses/Door3,/turf/teleport/buildingteleports/Konoha_Kage_House_Top2/_2/Down,/area)
"C" = (/turf/inside/floors/floors11,/turf/teleport/buildingteleports/Konoha_Kage_House/_1/INSIDE,/area)
"D" = (/turf/inside/floors/floors11,/turf/teleport/buildingteleports/Konoha_Kage_House/_2/INSIDE,/area)

(1,1,1) = {"
aaaaaaaaaaaaaaaaaaaaaaaaaaaaaaaaaaaaaaaaaaaaaaaaaaaaaaaaaaaaaaaaaaaaaaaaaaaaaaaaaaaaaaaaaaaaaaaaaaaa
aaaaaaaaaaaaaaaaaaaaaaaaaaaaaaaaaaaaaaaaaaaaaaaaaaaaaaaaaaaaaaaaaaaaaaaaaaaaaaaaaaaaaaaaaaaaaaaaaaaa
aaaaaaaaaaaaaaaaaaaaaaaaaaaaaaaaaaaaaaaaaaaaaaaaaaaaaaaaaaaaaaaaaaaaaaaaaaaaaaaaaaaaaaaaaaaaaaaaaaaa
aaaaaaaaaaaaaaaaaaaaaaaaaaaaaaaaaaaaaaaaaaaaaaaaaaaaaaaaaaaaaaaaaaaaaaaaaaaaaaaaaaaaaaaaaaaaaaaaaaaa
aaaaaaaaaaaaaaaaaaaaaaaaaaaaaaaaaaaaaaaaaaaaaaaaaaaaaaaaaaaaaaaaaaaaaaaaaaaaaaaaaaaaaaaaaaaaaaaaaaaa
aaaaaaaaaaaaaaaaaaaaaaaaaaaaaaaaaaaaaaaaaaaaaaaaaaaaaaaaaaaaaaaaaaaaaaaaaaaaaaaaaaaaaaaaaaaaaaaaaaaa
aaaaaaaaaaaaaaaaaaaaaaaaaaaaaaaaaaaaaaaaaaaaaaaaaaaaaaaaaaaaaaaaaaaaaaaaaaaaaaaaaaaaaaaaaaaaaaaaaaaa
aaaaaaaaaaaaaaaaaaaaaaaaaaaaaaaaaaaaaaaaaaaaaaaaaaaaaaaaaaaaaaaaaaaaaaaaaaaaaaaaaaaaaaaaaaaaaaaaaaaa
aaaaaaaaaaaaaaaaaaaaaaaaaaaaaaaaaaaaaaaaaaaaaaaaaaaaaaaaaaaaaaaaaaaaaaaaaaaaaaaaaaaaaaaaaaaaaaaaaaaa
aaaaaaaaaaaaaaaaaaaaaaaaaaaaaaaaaaaaaaaaaaaaaaaaaaaaaaaaaaaaaaaaaaaaaaaaaaaaaaaaaaaaaaaaaaaaaaaaaaaa
aaaaaaaaaaaaaaaaaaaaaaaaaaaaaaaaaaaaaaaaaaaaaaaaaaaaaaaaaaaaaaaaaaaaaaaaaaaaaaaaaaaaaaaaaaaaaaaaaaaa
aaaaaaaaaaaaaaaaaaaaaaaaaaaaaaaaaaaaaaaaaaaaaaaaaaaaaaaaaaaaaaaaaaaaaaaaaaaaaaaaaaaaaaaaaaaaaaaaaaaa
aaaaaaaaaaaaaaaaaaaaaaaaaaaaaaaaaaaaaaaaaaaaaaaaaaaaaaaaaaaaaaaaaaaaaaaaaaaaaaaaaaaaaaaaaaaaaaaaaaaa
aaaaaaaaaaaaaaaaaaaaaaaaaaaaaaaaaaaaaaaaaaaaaaaaaaaaaaaaaaaaaaaaaaaaaaaaaaaaaaaaaaaaaaaaaaaaaaaaaaaa
aaaaaaaaaaaaaaaaaaaaaaaaaaaaaaaaaaaaaaaaaaaaaaaaaaaaaaaaaaaaaaaaaaaaaaaaaaaaaaaaaaaaaaaaaaaaaaaaaaaa
aaaaaaaaaaaaaaaaaaaaaaaaaaaaaaaaaaaaaaaaaaaaaaaaaaaaaaaaaaaaaaaaaaaaaaaaaaaaaaaaaaaaaaaaaaaaaaaaaaaa
aaaaaaaaaaaaaaaaaaaaaaaaaaaaaaaaaaaaaaaaaaaaaaaaaaaaaaaaaaaaaaaaaaaaaaaaaaaaaaaaaaaaaaaaaaaaaaaaaaaa
aaaaaaaaaaaaaaaaaaaaaaaaaaaaaaaaaaaaaaaaaaaaaaaaaaaaaaaaaaaaaaaaaaaaaaaaaaaaaaaaaaaaaaaaaaaaaaaaaaaa
aaaaaaaaaaaaaaaaaaaaaaaaaaaaaaaaaaaaaaaaaaaaaaaaaaaaaaaaaaaaaaaaaaaaaaaaaaaaaaaaaaaaaaaaaaaaaaaaaaaa
aaaaaaaaaaaaaaaaaaaaaaaaaaaaaaaaaaaaaaaaaaaaaaaaaaaaaaaaaaaaaaaaaaaaaaaaaaaaaaaaaaaaaaaaaaaaaaaaaaaa
aaaaaaaaaaaaaaaaaaaaaaaaaaaaaaaaaaaaaaaaaaaaaaaaaaaaaaaaaaaaaaaaaaaaaaaaaaaaaaaaaaaaaaaaaaaaaaaaaaaa
aaaaaaaaaaaaaaaaaaaaaaaaaaaaaaaaaaaaaaaaaaaaaaaaaaaaaaaaaaaaaaaaaaaaaaaaaaaaaaaaaaaaaaaaaaaaaaaaaaaa
aabbbbbbbbbbbbbbbbbbbbbbbbbbbbbbbbbbbbbbbbbbbbbbbbbbbbbbbbbbbbbbbbbbbbbbbbbbbbbbbbbbbbbbbbbbbbbbbaaa
aabbbbbbbbbbbbbbbbbbbbbbbbbbbbbbbbbbbbbbbbbbbbbbbbbbbbbbbbbbbbbbbbbbbbbbbbbbbbbbbbbbbbbbbbbbbbbbbaaa
aabbbbbbbbbbbbbbbbbbbbbbbbbbbbbbbbbbbbbbbbbbbbbbbbbbbbbbbbbbbbbbbbbbbbbbbbbbbbbbbbbbbbbbbbbbbbbbbaaa
aabbbbbbbbbbbbbbbbbbbbbbbbbbbbbbccccbbbbbbbbbbbbcccccccccbbbbbbbbbbbbccccbbbbbbbbbbbbbbbbbbbbbbbbaaa
aabbbbbbbbbbbbbbbbbbbbbbbbbbbbbdeeeefbbbbbbbbbbdeeeegeeeefbbbbbbbbbbdeeeefbbbbbbbbbbbbbbbbbbbbbbbaaa
aabbbbbbbbbbbbbbbbbbbbbbbbbbbbbdhhhhfbbbbbbbbbbdhihjklhihfbbbbbbbbbbdhhhhfbbbbbbbbbbbbbbbbbbbbbbbaaa
aabbbbbbbbbbbbbbbbbbbbbbbbbbbbbdmnomfbbbbbbbbbbdmmmmmmmmmfbbbbbbbbbbdmpqmfbbbbbbbbbbbbbbbbbbbbbbbaaa
aabbbbbbbbbbbbbbbbbbbbbbbbbbbbbdrrrrfbbbbbbbbbbdsssstssssfbbbbbbbbbbdrrrrfbbbbbbbbbbbbbbbbbbbbbbbaaa
aabbbbbbbbbbbbbbbbbbbbbbbbbbbbbdrrrrfbbbbbbbbbbdssuvvvwssfbbbbbbbbbbdrrrrfbbbbbbbbbbbbbbbbbbbbbbbaaa
aabbbbbbbbbbbbbbbbbbbbbbbbbbbbbdrrrrfbbbbbbbbbbdsstststssfbbbbbbbbbbdrrrrfbbbbbbbbbbbbbbbbbbbbbbbaaa
aabbbbbbbbbbbbbbbbbbbbbbbbbbbbbdrrrrfbbbbbbbbbbdsssssssssfbbbbbbbbbbdrrrrfbbbbbbbbbbbbbbbbbbbbbbbaaa
aabbbbbbbbbbbbbbbbbbbbbbbbbbbbbdrrrrfbbbbbbbbbbdsssssssssfbbbbbbbbbbdrrrrfbbbbbbbbbbbbbbbbbbbbbbbaaa
aabbbbbbbbbbbbbbbbbbbbbbbbbbbbbdrrrrfbbbbbbbbbbxxxsssssxxxbbbbbbbbbbdrrrrfbbbbbbbbbbbbbbbbbbbbbbbaaa
aabbbbbbbbbbbbbbbbbbbbbbbbbbbbbdrrrrfbbbbbbbbbbbbbdsssfbbbbbbbbbbbbbdrrrrfbbbbbbbbbbbbbbbbbbbbbbbaaa
aabbbbbbbbbbbbbbbbbbbbbbbbbbbbbdrrrrfbbbbbbbbbbbbbdsssfbbbbbbbbbbbbbdrrrrfbbbbbbbbbbbbbbbbbbbbbbbaaa
aabbbbbbbbbbbbbbbbbbbbbbbbbbbbbdrrrrfbbbbbbbbbbbbbdsssfbbbbbbbbbbbbbdrrrrfbbbbbbbbbbbbbbbbbbbbbbbaaa
aabbbbbbbbbbbbbbbbbbbbbbbbbbbbbdrrrrecbbbbbbbbbbbbdsssfbbbbbbbbbbbbcerrrrfbbbbbbbbbbbbbbbbbbbbbbbaaa
aabbbbbbbbbbbbbbbbbbbbbbbbbbbbbdrrrrhecbbbbbbbbbbbdsssfbbbbbbbbbbbcehrrrrfbbbbbbbbbbbbbbbbbbbbbbbaaa
aabbbbbbbbbbbbbbbbbbbbbbbbbbbbbdrrrrmheccccccccccccsssccccccccccccehmrrrrfbbbbbbbbbbbbbbbbbbbbbbbaaa
aabbbbbbbbbbbbbbbbbbbbbbbbbbbbbdrrrrrmheeeeeeeeeeeessseeeeeeeeeeeehmrrrrrfbbbbbbbbbbbbbbbbbbbbbbbaaa
aabbbbbbbbbbbbbbbbbbbbbbbbbbbbbdrrrrrrmhhhhhhhhhhhhssshhhhhhhhhhhhmrrrrrrfbbbbbbbbbbbbbbbbbbbbbbbaaa
aabbbbbbbbbbbbbbbbbbbbbbbbbbbbbbxrrrrrrmmmmmmmmmmmmsssmmmmmmmmmmmmrrrrrrxbbbbbbbbbbbbbbbbbbbbbbbbaaa
aabbbbbbbbbbbbbbbbbbbbbbbbbbbbbbbxrrrrrrrrrrrrrrrrrrrrrrrrrrrrrrrrrrrrrxbbbbbbbbbbbbbbbbbbbbbbbbbaaa
aabbbbbbbbbbbbbbbbbbbbbbbbbbbbbbbbxrrrrrrrrrrrrrrrrrrrrrrrrrrrrrrrrrrrxbbbbbbbbbbbbbbbbbbbbbbbbbbaaa
aabbbbbbbbbbbbbbbbbbbbbbbbbbbbbbbbbxrrrrrrrrrrrrrrrrrrrrrrrrrrrrrrrrrxbbbbbbbbbbbbbbbbbbbbbbbbbbbaaa
aabbbbbbbbbbbbbbbbbbbbbbbbbbbbbbbbbbxxxxxxxxxxxxxxxxxxxxxxxxxxxxxxxxxbbbbbbbbbbbbbbbbbbbbbbbbbbbbaaa
aabbbbbbbbbbbbbbbbbbbbbbbbbbbbbbbbbbbbbbbbbbbbbbbbbbbbbbbbbbbbbbbbbbbbbbbbbbbbbbbbbbbbbbbbbbbbbbbaaa
aabbbbbbbbbbbbbbbbbbbbbbbbbbbbbbbbbbbbbbbbbbbbbbbbbbbbbbbbbbbbbbbbbbbbbbbbbbbbbbbbbbbbbbbbbbbbbbbaaa
aabbbbbbbbbbbbbbbbbbbbbbbbbbbbbbbbbbbbbbbbbbbbbbbbbbbbbbbbbbbbbbbbbbbbbbbbbbbbbbbbbbbbbbbbbbbbbbbaaa
aabbbbbbbbbbbbbbbbbbbbbbbbbbbbbbbbbbbbbbbbbbbbbbbbbbbbbbbbbbbbbbbbbbbbbbbbbbbbbbbbbbbbbbbbbbbbbbbaaa
aabbbbbbbbbbbbbbbbbbbbbbbbbbbbbbbbbbbbbbbbbbbbbbbbbbbbbbbbbbbbbbbbbbbbbbbbbbbbbbbbbbbbbbbbbbbbbbbaaa
aabbbbbbbbbbbbbbbbbbbbbbbbbbbbbbbbbbbbbbbbbbbbbbbbbbbbbbbbbbbbbbbbbbbbbbbbbbbbbbbbbbbbbbbbbbbbbbbaaa
aabbbbbbbbbbbbbbbbbbbbbbbbbbbbbbbbbbbbbbbbbbbbbbbbbbbbbbbbbbbbbbbbbbbbbbbbbbbbbbbbbbbbbbbbbbbbbbbaaa
aabbbbbbbcccccccccccccccbbbbbbbbbbbbbbbbbbbbbbbbbbbbbbbbbbbbbbbbbbbbbbbbbbbbbbbbbcccccccccccccccbaaa
aabbbbbbdeeeeeeeeeeeeeeefbbbbbbbccccbbbbbbbbbbbbcccccccccbbbbbbbbbbbbccccbbbbbbbdeeeeeeeeeeeeeeefaaa
aabbbbbbdhhhhhhhhhhhhhhhfbbbbbbdeeeefbbbbbbbbbbdeeeeeeeeefbbbbbbbbbbdeeeefbbbbbbdhhhhhhhhhhhhhhhfaaa
aabbbbbbdmmmmmmmmmmmmmmmfbbbbbbdhhhhfbbbbbbbbbbdhhhhhhhhhfbbbbbbbbbbdhhhhfbbbbbbdmmmmmmmmmmmmmmmfaaa
aabbbbbbdsssssssssssssssfbbbbbbdmyzmfbbbbbbbbbbdmmmmmmmmmfbbbbbbbbbbdmABmfbbbbbbdsssssssssssssssfaaa
aabbbbbbdsssssssssssssssfbbbbbbdrrrrfbbbbbbbbbbdsssssssssfbbbbbbbbbbdrrrrfbbbbbbdsssssssssssssssfaaa
aabbbbbbdsssssssssssssssfccccccdrrrrfbbbbbbbbbbdsssssssssfbbbbbbbbbbdrrrrfccccccdsssssssssssssssfaaa
aabbbbbbdssssssssssssssseeeeeeeerrrrfbbbbbbbbbbdsssssssssfbbbbbbbbbbdrrrreeeeeeeesssssssssssssssfaaa
aabbbbbbdssssssssssssssshhhhhhhhrrrrfbbbbbbbbbbdsssssssssfbbbbbbbbbbdrrrrhhhhhhhhsssssssssssssssfaaa
aabbbbbbdsssssssssssssssmmmmmmmmrrrrfbbbbbbbbbbdsssssssssfbbbbbbbbbbdrrrrmmmmmmmmsssssssssssssssfaaa
aabbbbbbdsssssssssssssssssssssssrrrrfbbbbbbbbbbxxxsssssxxxbbbbbbbbbbdrrrrsssssssssssssssssssssssfaaa
aabbbbbbdsssssssssssssssssssssssrrrrfbbbbbbbbbbbbbdsssfbbbbbbbbbbbbbdrrrrsssssssssssssssssssssssfaaa
aabbbbbbdsssssssssssssssssssssssrrrrfbbbbbbbbbbbbbdsssfbbbbbbbbbbbbbdrrrrsssssssssssssssssssssssfaaa
aabbbbbbdsssssssssssssssfxxxxxxdrrrrfbbbbbbbbbbbbbdsssfbbbbbbbbbbbbbdrrrrfxxxxxxdsssssssssssssssfaaa
aabbbbbbdsssssssssssssssfbbbbbbdrrrrecbbbbbbbbbbbbdsssfbbbbbbbbbbbbcerrrrfbbbbbbdsssssssssssssssfaaa
aabbbbbbdsssssssssssssssfbbbbbbdrrrrhecbbbbbbbbbbbdsssfbbbbbbbbbbbcehrrrrfbbbbbbdsssssssssssssssfaaa
aabbbbbbdsssssssssssssssfbbbbbbdrrrrmheccccccccccccsssccccccccccccehmrrrrfbbbbbbdsssssssssssssssfaaa
aabbbbbbdsssssssssssssssfbbbbbbdrrrrrmheeeeeeeeeeeessseeeeeeeeeeeehmrrrrrfbbbbbbdsssssssssssssssfaaa
aabbbbbbdsssssssssssssssfbbbbbbdrrrrrrmhhhhhhhhhhhhssshhhhhhhhhhhhmrrrrrrfbbbbbbdsssssssssssssssfaaa
aabbbbbbbxxxxxxxxxxxxxxxbbbbbbbbxrrrrrrmmmmmmmmmmmmsssmmmmmmmmmmmmrrrrrrxbbbbbbbbxxxxxxxxxxxxxxxbaaa
aabbbbbbbbbbbbbbbbbbbbbbbbbbbbbbbxrrrrrrrrrrrrrrrrrrrrrrrrrrrrrrrrrrrrrxbbbbbbbbbbbbbbbbbbbbbbbbbaaa
aabbbbbbbbbbbbbbbbbbbbbbbbbbbbbbbbxrrrrrrrrrrrrrrrrrrrrrrrrrrrrrrrrrrrxbbbbbbbbbbbbbbbbbbbbbbbbbbaaa
aabbbbbbbbbbbbbbbbbbbbbbbbbbbbbbbbbxrrrrrrrrrrrrrrrrrrrrrrrrrrrrrrrrrxbbbbbbbbbbbbbbbbbbbbbbbbbbbaaa
aabbbbbbbbbbbbbbbbbbbbbbbbbbbbbbbbbbxxxxxxxxxxxxxxxCCDxxxxxxxxxxxxxxxbbbbbbbbbbbbbbbbbbbbbbbbbbbbaaa
aabbbbbbbbbbbbbbbbbbbbbbbbbbbbbbbbbbbbbbbbbbbbbbbbbxxxbbbbbbbbbbbbbbbbbbbbbbbbbbbbbbbbbbbbbbbbbbbaaa
aabbbbbbbbbbbbbbbbbbbbbbbbbbbbbbbbbbbbbbbbbbbbbbbbbbbbbbbbbbbbbbbbbbbbbbbbbbbbbbbbbbbbbbbbbbbbbbbaaa
aabbbbbbbbbbbbbbbbbbbbbbbbbbbbbbbbbbbbbbbbbbbbbbbbbbbbbbbbbbbbbbbbbbbbbbbbbbbbbbbbbbbbbbbbbbbbbbbaaa
aabbbbbbbbbbbbbbbbbbbbbbbbbbbbbbbbbbbbbbbbbbbbbbbbbbbbbbbbbbbbbbbbbbbbbbbbbbbbbbbbbbbbbbbbbbbbbbbaaa
aabbbbbbbbbbbbbbbbbbbbbbbbbbbbbbbbbbbbbbbbbbbbbbbbbbbbbbbbbbbbbbbbbbbbbbbbbbbbbbbbbbbbbbbbbbbbbbbaaa
aabbbbbbbbbbbbbbbbbbbbbbbbbbbbbbbbbbbbbbbbbbbbbbbbbbbbbbbbbbbbbbbbbbbbbbbbbbbbbbbbbbbbbbbbbbbbbbbaaa
aabbbbbbbbbbbbbbbbbbbbbbbbbbbbbbbbbbbbbbbbbbbbbbbbbbbbbbbbbbbbbbbbbbbbbbbbbbbbbbbbbbbbbbbbbbbbbbbaaa
aabbbbbbbbbbbbbbbbbbbbbbbbbbbbbbbbbbbbbbbbbbbbbbbbbbbbbbbbbbbbbbbbbbbbbbbbbbbbbbbbbbbbbbbbbbbbbbbaaa
aabbbbbbbbbbbbbbbbbbbbbbbbbbbbbbbbbbbbbbbbbbbbbbbbbbbbbbbbbbbbbbbbbbbbbbbbbbbbbbbbbbbbbbbbbbbbbbbaaa
aabbbbbbbbbbbbbbbbbbbbbbbbbbbbbbbbbbbbbbbbbbbbbbbbbbbbbbbbbbbbbbbbbbbbbbbbbbbbbbbbbbbbbbbbbbbbbbbaaa
aabbbbbbbbbbbbbbbbbbbbbbbbbbbbbbbbbbbbbbbbbbbbbbbbbbbbbbbbbbbbbbbbbbbbbbbbbbbbbbbbbbbbbbbbbbbbbbbaaa
aabbbbbbbbbbbbbbbbbbbbbbbbbbbbbbbbbbbbbbbbbbbbbbbbbbbbbbbbbbbbbbbbbbbbbbbbbbbbbbbbbbbbbbbbbbbbbbbaaa
aabbbbbbbbbbbbbbbbbbbbbbbbbbbbbbbbbbbbbbbbbbbbbbbbbbbbbbbbbbbbbbbbbbbbbbbbbbbbbbbbbbbbbbbbbbbbbbbaaa
aaaaaaaaaaaaaaaaaaaaaaaaaaaaaaaaaaaaaaaaaaaaaaaaaaaaaaaaaaaaaaaaaaaaaaaaaaaaaaaaaaaaaaaaaaaaaaaaaaaa
aaaaaaaaaaaaaaaaaaaaaaaaaaaaaaaaaaaaaaaaaaaaaaaaaaaaaaaaaaaaaaaaaaaaaaaaaaaaaaaaaaaaaaaaaaaaaaaaaaaa
aaaaaaaaaaaaaaaaaaaaaaaaaaaaaaaaaaaaaaaaaaaaaaaaaaaaaaaaaaaaaaaaaaaaaaaaaaaaaaaaaaaaaaaaaaaaaaaaaaaa
aaaaaaaaaaaaaaaaaaaaaaaaaaaaaaaaaaaaaaaaaaaaaaaaaaaaaaaaaaaaaaaaaaaaaaaaaaaaaaaaaaaaaaaaaaaaaaaaaaaa
aaaaaaaaaaaaaaaaaaaaaaaaaaaaaaaaaaaaaaaaaaaaaaaaaaaaaaaaaaaaaaaaaaaaaaaaaaaaaaaaaaaaaaaaaaaaaaaaaaaa
aaaaaaaaaaaaaaaaaaaaaaaaaaaaaaaaaaaaaaaaaaaaaaaaaaaaaaaaaaaaaaaaaaaaaaaaaaaaaaaaaaaaaaaaaaaaaaaaaaaa
aaaaaaaaaaaaaaaaaaaaaaaaaaaaaaaaaaaaaaaaaaaaaaaaaaaaaaaaaaaaaaaaaaaaaaaaaaaaaaaaaaaaaaaaaaaaaaaaaaaa
aaaaaaaaaaaaaaaaaaaaaaaaaaaaaaaaaaaaaaaaaaaaaaaaaaaaaaaaaaaaaaaaaaaaaaaaaaaaaaaaaaaaaaaaaaaaaaaaaaaa
"}
